1111111111111
1000110000001
1001000000EC1
1000110000001
100P011111001
1000110000001
1000110000001
1000110000001
1111111111111
