1111111111111
1P000000000C1
1000000000001
100E000000001
1111111111111
