11111111111111111111111
10010000000C10000000001
100001111100100000C1001
10000000000111000000001
100000C0001100000000001
100000000000C0000000001
100001111000C0000000001
10011111111100000000001
100000C00000C0000000011
1P0011E0000010000000001
11111111111111111111111
